не	отрицательная частица
я	местоимение
ты	местоимение
вы	местоимение
он	местоимение
ему	местоимение
им	местоимение
ей	местоимение
ею	местоимение
им	местоимение
ими	местоимение
них	местоимение
нем	местоимение
ней	местоимение
она	местоимение
оно	местоимение
мы	местоимение
они	местоимение
мой	местоимение
мои	местоимение
наш	местоимение
наши	местоимение
твой	местоимение
ваш	местоимение
твои	местоимение
ваши	местоимение
его	местоимение
ее	местоимение
его	местоимение
ее	местоимение
их	местоимение
свой	местоимение
свои	местоимение
кто	местоимение
что	местоимение
сколько	местоимение
какой	местоимение
каков	местоимение
чей	местоимение
чья	местоимение
чью	местоимение
чьи	местоимение
который	местоимение
которая	местоимение
которые	местоимение
которых	местоимение
которую	местоимение
которого	местоимение
куда	местоимение
когда	местоимение
как	местоимение
зачем	местоимение
почему	местоимение
этот	указательное местоимение
это	указательное местоимение
эти	указательное местоимение
этих	указательное местоимение
тот	указательное местоимение
такой	указательное местоимение
таков	указательное местоимение
то	указательное местоимение
этакий	указательное местоимение
оный	указательное местоимение
экий	указательное местоимение
вот	указательное местоимение
все	определительное местоимение
весь	определительное местоимение
всякий	определительное местоимение
сам	определительное местоимение
самый	определительное местоимение
каждый	определительное местоимение
любой	определительное местоимение
другой	определительное местоимение
иной	определительное местоимение
никто	отрицательное местоимение
ничто	отрицательное местоимение
нечего	отрицательное местоимение
никакой	отрицательное местоимение
ничей	отрицательное местоимение
негде	отрицательное местоимение
некуда	отрицательное местоимение
никогда	отрицательное местоимение
незачем	отрицательное местоимение
никак	отрицательное местоимение
некто	неопределенное местоимение
нечто	неопределенное местоимение
несколько	неопределенное местоимение
некогда	неопределенное местоимение
некоторый	неопределенное местоимение
некоторые	неопределенное местоимение
некоторым	неопределенное местоимение
некоторых	неопределенное местоимение
нескольких	неопределенное местоимение
которого	местоимение
свой	местоимение
своего	местоимение
своя	местоимение
своей	местоимение
свое	местоимение
своего	местоимение
свои	местоимение
своих	местоимение
один	местоимение
одно	местоимение
одного	местоимение
одна	местоимение
одной	местоимение
одну	местоимение
одни	местоимение
одних	местоимение
пушкин	великий русский поэт