без	род. п.
безо	род. п.
благодаря	дат. п.
близ	род. п.
в	вин. п.
в	предл. п.
ввиду	род. п.
вглубь	род. п.
вдоль	род. п.
взамен	род. п.
включая	вин. п.
вместо	род. п.
вне	род. п.
внизу	род. п.
внутри	род. п.
внутрь	род. п.
во	вин. п.
во	предл. п.
вопреки	дат. п.
впереди	род. п.
вроде	род. п.
вслед	дат. п.
вследствие	род. п.
для	род. п.
до	род. п.
за	вин. п.
за	твор. п.
заместо	род. п.
из	род. п.
из-за	род. п.
из-под	род. п.
изнутри	род. п.
изо	род. п.
к	дат. п.
ко	дат. п.
кроме	род. п.
меж	род. п.
меж	твор. п.
между	род. п.
между	твор. п.
мимо	род. п.
на	вин. п.
на	предл. п.
наверху	род. п.
навстречу	род. п.
над	твор. п.
надо	твор. п.
навстречу	дат. п.
наперекор	дат. п.
накануне	род. п.
наперерез	дат. п.
наподобие	род. п.
напротив	род. п.
насупротив	род. п.
насчёт	род. п.
несмотря	вин. п.
ниже	род. п.
о	вин. п.
о	предл. п.
об	вин. п.
об	предл. п.
обо	вин. п.
обо	предл. п.
около	род. п.
окромя	род. п.
округ	род. п.
от	род. п.
относительно	род. п.
ото	род. п.
перед	твор. п.
передо	твор. п.
по	вин. п.
по	дат. п.
по	предл. п.
поверх	род. п.
под	вин. п.
подобно	дат. п.
подо	вин. п.
подо	твор. п.
помимо	род. п.
поперёк	род. п.
посередине	род. п.
после	род. п.
посреди	род. п.
посредине	род. п.
посредством	род. п.
пред	твор. п.
прежде	род. п.
при	предл. п.
про	вин. п.
против	род. п.
ради	род. п.
рядом	твор. п.
с	род. п.
с	ин. п.
с	твор. п.
сверх	род. п.
свыше	вин. п.
сквозь	род. п.
сзади	род. п.
спереди	род. п.
свыше	род. п.
супротив	род. п.
снизу	род. п.
со	род. п.
со	вин. п.
со	твор. п.
согласно	дат. п.
среди	род. п.
спустя	вин. п.
супротив	род. п.
у	род. п.
через	вин. п.
чрез	вин. п.